255,255,255,53,255,255,255,255,255,246,247,247,247,247,247,247,247,247,247,248,255,255,46,47,47,47,47,47,47,47,
255,255,255,53,255,255,255,255,255,246,247,247,247,247,247,247,247,247,247,248,255,255,46,47,47,47,47,47,47,47,
255,255,255,53,255,255,255,255,255,246,247,247,247,247,247,247,247,247,247,248,255,255,78,110,47,47,47,47,47,47,
255,255,255,53,255,255,255,255,255,246,247,247,247,247,247,247,247,247,247,248,255,255,255,46,47,47,47,47,47,47,
255,255,255,53,255,255,255,255,255,246,247,247,247,247,247,247,247,247,247,248,255,255,255,78,110,47,47,47,47,47,
255,255,255,53,255,255,255,255,255,246,247,247,247,247,247,247,247,247,247,248,255,255,255,255,46,47,47,47,47,47,
255,255,255,53,255,255,255,255,255,278,310,247,247,247,247,247,247,309,279,280,255,255,255,57,172,47,47,47,47,47,
255,255,49,88,255,255,255,255,255,255,278,247,247,247,247,247,247,248,255,255,255,255,255,61,78,110,47,47,47,47,
255,255,53,255,255,255,255,255,255,255,255,278,279,279,279,279,279,280,255,255,255,255,255,61,255,46,47,47,47,47,
255,255,53,255,255,255,255,255,255,255,255,255,255,255,255,255,255,255,255,255,255,255,255,61,255,78,79,79,79,79,
255,255,53,255,255,255,255,255,255,255,255,255,255,255,255,255,255,255,255,255,255,255,255,61,255,255,255,255,255,255,
255,255,53,255,255,255,255,255,255,255,255,255,255,255,255,255,255,255,255,255,255,255,255,61,255,255,255,255,255,255,
255,255,53,255,255,255,255,255,255,255,255,255,255,255,255,255,255,255,255,255,255,255,255,61,255,255,255,255,255,255,
255,255,53,255,255,255,255,255,255,255,255,255,255,255,255,255,255,255,255,255,255,255,255,61,255,255,255,255,255,255,
255,255,53,255,255,255,255,255,255,255,255,255,255,255,255,255,255,255,255,255,255,255,255,61,255,255,255,255,255,255,
255,255,53,255,255,255,255,255,255,255,49,19,19,19,19,19,19,19,19,19,50,255,255,61,255,255,255,255,255,255,
255,255,53,255,255,255,255,255,255,255,53,255,255,255,255,255,255,255,255,255,53,255,255,61,255,255,30,31,31,31,
255,255,51,19,19,19,19,19,19,19,82,255,255,255,255,255,255,30,31,31,185,31,31,185,31,31,158,63,63,63,
255,255,53,255,255,255,255,255,255,255,255,255,255,255,255,255,30,158,63,63,63,63,63,63,63,63,63,63,63,63,
255,255,53,255,255,255,255,255,255,255,255,255,255,255,255,30,63,63,63,63,63,63,63,63,63,63,63,63,63,63